##########
#        #
#  ####  #
#  #  #  #
###$##@###
