  ## #  $
# #  #####
####  ###
  #   ##
 ## # ###
 ## ###
### ######
  @######
     #
  # #  ## 
